{
  "cols":15,
  "rows":15,
  "tileInfoKeys":["Grass","Road","Bush","Water","Lilypad"],
  "tiles":[
    0,0,0,0,0,2,1,2,1,2,0,0,0,0,0,
    1,1,1,1,1,1,1,0,1,1,1,1,1,1,1,
    0,0,0,0,2,0,0,0,0,0,2,0,0,0,0,
    2,0,0,3,3,3,3,3,3,3,3,3,0,0,2,
    0,0,0,3,3,3,3,3,3,3,3,3,2,0,0,
    0,0,3,3,3,3,3,3,3,3,3,3,3,2,0,
    0,0,3,3,3,3,3,3,3,3,3,3,3,0,0,
    2,0,3,3,4,3,3,4,3,3,4,3,3,0,2,
    0,0,3,3,3,3,3,3,3,3,3,3,3,2,0,
    0,2,3,3,3,3,3,3,3,3,3,3,3,0,0,
    0,0,0,3,3,3,3,3,3,3,3,3,2,0,2,
    0,0,0,3,3,3,3,3,3,3,3,3,0,0,0,
    0,2,0,0,2,0,0,0,0,0,2,0,0,2,0,
    1,1,1,1,1,1,1,0,1,1,1,1,1,1,1,
    0,0,0,0,0,2,1,2,1,2,0,0,0,0,0
  ],
  "directions":[
    3,0,0,0,0,0,3,0,1,0,0,0,0,0,3,
    2,2,2,2,2,2,2,0,1,2,2,2,2,2,2,
    0,0,0,0,0,0,0,0,0,0,0,0,0,0,0,
    0,0,0,4,4,4,4,4,4,4,4,3,0,0,0,
    0,0,0,1,3,2,2,2,2,2,2,3,0,0,0,
    0,0,4,1,3,4,4,4,4,3,1,4,3,0,0,
    0,0,1,3,2,1,3,2,2,3,1,2,3,0,0,
    0,0,1,3,0,1,3,3,1,3,2,1,3,0,0,
    0,0,1,4,3,1,4,4,1,3,4,1,3,0,0,
    0,0,1,2,3,1,2,2,2,2,1,3,2,0,0,
    0,0,0,1,4,4,4,4,4,4,1,3,0,0,0,
    0,0,0,1,2,2,2,2,2,2,2,2,0,0,0,
    0,0,0,0,0,0,0,0,0,0,0,0,0,0,0,
    4,4,4,4,4,4,3,0,4,4,4,4,4,4,4,
    1,0,0,0,0,0,3,0,1,0,0,0,0,0,1
  ],
  "entities":{
    "Turtle":[
      [6,3],
      [10,3],
      [12,6],
      [11,11],
      [5,11],
      [9,4],
      [3,5],
      [4,5],
      [2,6],
      [5,10],
      [10,9],
      [5,5],
      [8,6],
      [9,6],
      [6,7],
      [7,9]
    ],
      "Froggy4":[[10,7]],
      "Froggy3":[[4,7]],
      "Froggy1":[[0,0]],
      "Froggy2":[[14,0]],
      "Froggy6":[[14,14]],
      "Froggy5":[[0,14]],
      "BlueCar":[[1,13],[4,13]],
      "GreenCar":[[8,13],[13,13]],
      "YellowCar":[[13,1],[8,1]],
      "RedCar":[[6,1],[1,1]]},
  "player":[7,7],
  "time":15000}