{
  "cols":17,
  "rows":15,
  "crop":[1,0,15,14],
  "tileInfoKeys":["Grass","Bush","Road"],
  "tiles":[
    0,0,0,0,1,0,0,0,0,0,0,1,0,0,0,0,0,
    0,0,0,0,0,0,0,0,0,0,0,0,0,0,0,0,0,
    0,0,1,0,0,0,1,0,0,0,0,0,0,1,0,0,0,
    0,0,0,0,0,0,0,0,0,0,0,0,0,0,0,0,0,
    0,0,0,0,1,0,0,0,0,1,0,0,0,0,0,0,0,
    0,0,0,0,0,0,0,0,0,0,0,0,0,0,0,0,0,
    0,2,2,2,2,2,2,2,2,2,2,2,2,2,2,2,0,
    0,2,2,2,2,2,2,2,2,2,2,2,2,2,2,2,0,
    0,2,2,2,2,2,2,2,2,2,2,2,2,2,2,2,0,
    0,0,0,0,0,0,0,0,0,0,0,0,0,0,0,0,0,
    0,0,0,0,0,0,0,1,0,0,0,1,0,0,0,0,0,
    0,0,0,1,0,0,0,0,0,0,0,0,0,0,0,0,0,
    0,0,0,0,0,0,0,0,0,0,1,0,0,0,0,0,0,
    0,0,0,0,0,1,0,0,0,0,0,0,0,1,0,0,0,
    0,0,0,0,0,0,0,0,0,0,0,0,0,0,0,0,0
  ],
  "directions":[
    0,0,0,0,0,0,0,0,0,0,0,0,0,0,0,3,0,
    0,0,0,0,0,0,0,0,0,0,0,0,0,0,0,0,0,
    0,0,0,0,0,0,0,0,1,0,0,0,0,0,0,0,0,
    0,0,0,0,0,0,0,0,0,0,0,0,0,0,0,0,0,
    0,0,0,0,0,0,0,0,0,0,0,0,0,0,0,0,0,
    0,0,0,0,0,0,0,0,0,0,0,0,0,0,0,0,0,
    0,2,2,2,2,2,2,2,2,2,2,2,2,2,2,2,2,
    4,4,4,4,4,4,4,4,4,4,4,4,4,4,4,4,0,
    0,2,2,2,2,2,2,2,2,2,2,2,2,2,2,2,2,
    0,0,0,0,0,0,0,0,0,0,0,0,0,0,0,0,0,
    0,0,0,0,0,0,0,0,0,0,0,0,0,0,1,0,0,
    0,0,0,0,0,0,0,0,0,0,0,0,0,0,0,0,0,
    0,0,1,0,0,0,0,1,0,0,0,0,0,0,0,0,0,
    0,0,0,0,0,0,0,0,0,0,0,0,0,0,0,0,0,
    0,0,0,0,0,0,0,0,0,0,0,0,0,0,0,0,0
  ],
  "warps":[
    [0,6,16,6],
    [16,7,0,7],
    [0,8,16,8]
  ],
  "entities":{
    "Froggy1":[[1,3]],
    "Froggy2":[[3,1]],
    "Froggy3":[[8,2]],
    "Froggy4":[[14,10]],
    "Froggy5":[[7,12]],
    "Froggy6":[[2,12]],
    "BlueCar":[[15,6],[10,6],[5,6]],
    "YellowCar":[[14,7],[7,7]],
    "GreenCar":[[12,8],[4,8]]
  },
  "player":[15,0],
  "time":18000
}