{
  "cols":15,
  "rows":15,
  "tileInfoKeys":["Grass","Road","Bush","Sidewalk"],
  "tiles":[
    0,0,0,2,1,1,1,1,1,1,1,1,2,0,0,
    0,2,1,1,1,1,1,1,1,1,1,1,1,1,0,
    2,1,1,1,1,1,1,1,1,1,1,1,1,1,0,
    1,1,1,1,1,1,1,1,1,1,1,0,1,1,2,
    1,1,1,1,1,1,1,1,1,1,1,1,1,1,1,
    1,1,1,1,1,1,3,3,3,1,1,1,1,1,1,
    1,1,1,1,1,3,2,0,2,3,1,1,1,1,1,
    1,1,1,1,1,3,0,0,0,3,1,1,1,1,1,
    1,1,1,1,1,3,2,0,2,3,1,1,1,1,1,
    1,1,1,1,1,1,3,3,3,1,1,1,1,1,1,
    1,1,1,1,1,1,1,1,1,1,1,1,1,1,1,
    2,1,1,0,1,1,1,1,1,1,1,1,1,1,1,
    0,1,1,1,1,1,1,1,1,1,1,1,1,1,2,
    0,1,1,1,1,1,1,1,1,1,1,1,1,2,0,
    0,0,2,1,1,1,1,1,1,1,1,2,0,0,0
  ],
  "directions":[
    3,0,0,0,3,3,3,3,1,1,1,1,0,0,3,
    0,0,3,2,2,3,3,3,1,1,1,1,2,2,0,
    0,3,2,3,2,2,3,3,1,1,1,2,2,1,0,
    2,2,3,2,3,2,2,3,1,1,2,3,1,1,0,
    2,2,2,3,2,3,2,2,1,2,1,2,1,1,2,
    2,2,2,2,3,2,0,0,0,1,2,1,1,2,2,
    2,2,2,2,2,0,0,0,0,0,1,1,2,2,2,
    4,4,4,4,3,0,0,1,0,0,1,2,2,2,2,
    4,4,4,3,3,0,0,0,0,0,4,4,4,4,4,
    4,4,3,3,4,3,0,0,0,4,1,4,4,4,4,
    4,3,3,4,3,4,3,4,4,1,4,1,4,4,4,
    0,3,3,1,4,3,3,1,4,4,1,4,1,4,4,
    0,3,4,4,3,3,3,1,1,4,4,1,4,1,0,
    0,4,4,3,3,3,3,1,1,1,4,4,1,0,0,
    1,0,0,3,3,3,3,1,1,1,1,0,0,0,1
  ],
  "entities":{"Froggy1":[[0,0]],"Froggy2":[[14,0]],"Froggy6":[[14,14]],"Froggy5":[[0,14]],"Froggy3":[[11,3]],"Froggy4":[[3,11]],"BlueCar":[[3,1],[11,1],[13,4],[1,3],[0,10],[1,13],[11,13],[13,11]],"GreenCar":[[5,1],[11,2],[12,10],[9,14],[4,14],[2,11],[1,4],[14,5]],"RedCar":[[7,1],[4,5],[9,5],[9,9],[6,10],[7,12],[13,7],[0,7]],"YellowCar":[[9,1],[11,4],[11,9],[8,13],[4,11],[0,8],[2,5],[6,2]]},"player":[7,7],"time":10000}
